NO textures/greystone(2).xpm
SO textures/greystone(2).xpm
WE textures/greystone(2).xpm
EA textures/greystone(2).xpm


F 220,100,0
C 225,30,0



1111111111
1W00000001
1011111101
1000000101
1011100101
1000100001
1010101111
1000000001
1000000001
1111111111
