NO textures/greystone.xpm
SO textures/greystone.xpm
WE textures/greystone.xpm
EA textures/greystone.xpm


F 220,100,0
C 225,30,0



11111111111111111111
1S000001000010000001
10111001011010111001
10100010001000001011
10101011101110101001
10001000100010100001
10111110111010111101
10000000001000000101
10111011101110101101
10001000000000100001
10101011111110111101
11111111111111111111