NO textures/wall.xpm
SO textures/wall.xpm
WE textures/wall.xpm
EA textures/wall.xpm


C 5, 5, 5
F 5, 5, 5



1111111111111111111111111
1000000000000000000000001
1000100000000010000000001
1000000W00000010000000001
1000000100100010000100001
1000100000000010000100001
1000100010000010000100001
1000000000000010000100001
1000000000000010000000001
1000000010000010000000001
1000000010000010000000001
1000000000000010000000001
1000000000000010000000001
1000000000000000000000001
1111111111111111111111111
