NO textures/brown_walll.xpm
SO textures/dk_wall.xpm
WE textures/planks.xpm
EA textures/brown_walll.xpm

C 24, 66, 5
F 5, 5, 5

1111111111111111111111111
1000000000000000000000001
10001000000000100000000S1
1000000000000010000000001          
1000000100100010000100001	
1000100000000010000100001
1000100010000010000100001
1000000000000010000100001
1000000000000010000000001
1111111111111111111111111
