NO textures/brown_walll.xpm
SO textures/brown_walll.xpm
WE textures/brown_walll.xpm
EA textures/brown_walll.xpm

C 5, 5, 5
F 5, 5, 5

1111111111111111111111111
1N00000000000000000000001
1000100000000010000000001
1000000000000010000000001
1000000100100010000100001
1000100000000010000100001
1000100010000010000100001
1000000000000010000100001
1000000000000010000000001
1111111111111111111111111
