NO textures/brown_walll.xpm
SO textures/brown_walll.xpm
WE textures/brown_walll.xpm
EA textures/brown_walll.xpm



C 5, 5, 5
F 5, 5, 5







11111111111111111111
1S000001000010000001
10111001011010111001
10100010001000001011
101010111011101010011111
10001000100010100001
101111101111010111101
10000000001000000101
10111011101110101101
10001000000000100001
10101011111110111101
11111111111111111111





