NO textures/planks.xpm
SO textures/planks.xpm
WE textures/planks.xpm
EA textures/planks.xpm

C 38, 140, 180
F 92, 128, 45

1111111111111111111111111  
1000000000000000000000001
10001S0000000010000000001   
1000000000000010000000001
1000000100100010000100001   
1000100000000010000100001
1000100010000010000100001   
1000000000000010000100001   
1000000000000010000000001
1111111111111111111111111  
