NO textures/planks.xpm
SO textures/planks.xpm
WE textures/planks.xpm
EA textures/planks.xpm

C 38, 140, 180
F 92, 128, 45

1111111
1S0000111
100000001
100010001
1001 1001
1111 1111
